map = 5 7
#######
#.....#
#_.ss.#
#.....#
#######