map = 6 9
#########
#.......#
#__#.ss.#
#__#.ss.#
####....#
#########