map = 13 27
##########################
#........................#
#s..ss..ss..ss..ss..ss..s#
#s..ss..ss..ss..ss..ss..s#
#s..ss..ss..ss..ss..ss..s#
#s..ss..ss..ss..ss..ss..s#
#...........ss..ss..ss..s#
########.................#
########..___..___..___..#
########..___..___..___..#
########..___..___..___..#
########.................#
##########################