map = 15 30
##############################
#....................#.......#
#.ssssssss.ssssssss..#.......#
#.ssssssss.ssssssss..#.......#
#....................#..___..#
#.ssssssss.ssssssss.....___..#
#.ssssssss.ssssssss.....___..#
#....................#..___..#
#.ssssssss.ssssssss..#.......#
#.ssssssss.ssssssss..#.......#
#....................#.......#
#..ss............ss..#.......#
#..ss............ss..#.......#
#..ss............ss..#.......#
##############################
