map = 21 24
########################
#__....................#
#__.ssssssssssssssssss.#
#__.ssssssssssssssssss.#
###....................#
#__.ssssssssssssssssss.#
#__.ssssssssssssssssss.#
#__....................#
###....................#
#......................#
#......................#
#......................#
#......................#
#......................#
#......................#
#......................#
#......................#
#.ssssssssssssssssssss.#
#.ssssssssssssssssssss.#
#......................#
########################